BlinkLED	KEYWORD1
Charlieplex	KEYWORD1
ChaseLEDs	KEYWORD1

onTime	KEYWORD2
offTime	KEYWORD2
setBlinkRate	KEYWORD2

state	KEYWORD2
setState	KEYWORD2

pause	KEYWORD2
resume	KEYWORD2
isPaused	KEYWORD2

advanceTime	KEYWORD2
setAdvanceTime	KEYWORD2
previousPin	KEYWORD2

count	KEYWORD2
led	KEYWORD2
setLed	KEYWORD2
pwmLed	KEYWORD2
setPwmLed	KEYWORD2
holdTime	KEYWORD2
setHoldTime	KEYWORD2
refresh	KEYWORD2
